n, tCompl, tRecons, tTotal, costo, TrabMaqOut
1, 321, 14436, 14757, 5, 0
2, 0, 15399, 15399, 3, 1
3, 321, 17323, 17644, 8, 1
4, 321, 20210, 20531, 4, 2
5, 0, 22456, 22456, 10, 2
6, 321, 24702, 25023, 14, 2
7, 642, 27268, 27910, 23, 3
8, 321, 28230, 28551, 22, 5
9, 641, 29193, 29834, 24, 6
10, 962, 31118, 32080, 18, 4
11, 963, 33042, 34005, 28, 3
12, 962, 34005, 34967, 28, 3
13, 1284, 35930, 37214, 32, 6
14, 1283, 42025, 43308, 27, 7
15, 1604, 39780, 41384, 31, 6
16, 1604, 40422, 42026, 27, 5
17, 1925, 41704, 43629, 36, 9
18, 2245, 42667, 44912, 39, 10
19, 1925, 44913, 46838, 33, 7
20, 2246, 45875, 48121, 40, 10
21, 2888, 116451, 119339, 46, 10
22, 2246, 97203, 99449, 45, 12
23, 17323, 84050, 101373, 45, 14
24, 3208, 53253, 56461, 52, 9
25, 4170, 66085, 70255, 52, 11
26, 5133, 67689, 72822, 58, 21
27, 5454, 64160, 69614, 56, 11
28, 4491, 62877, 67368, 68, 13
29, 5132, 60311, 65443, 59, 10
30, 5774, 73464, 79238, 64, 17
31, 5775, 66406, 72181, 64, 16
32, 6095, 72501, 78596, 81, 18
33, 7058, 71539, 78597, 66, 13
34, 11228, 71860, 83088, 79, 17
35, 8020, 76030, 84050, 67, 17
36, 8983, 79559, 88542, 77, 19
37, 8982, 79879, 88861, 79, 20
38, 9624, 92712, 102336, 80, 18
39, 9945, 78917, 88862, 76, 22
40, 9303, 79558, 88861, 82, 16
41, 10907, 81805, 92712, 77, 22
42, 12190, 88862, 101052, 99, 20
43, 11870, 90787, 102657, 99, 21
44, 12512, 92070, 104582, 82, 15
45, 12832, 88862, 101694, 94, 21
46, 13795, 94958, 108753, 91, 25
47, 14436, 93032, 107468, 96, 26
48, 15398, 88541, 103939, 88, 12
49, 15720, 98807, 114527, 106, 22
50, 29193, 158155, 187348, 98, 17
51, 28872, 103298, 132170, 113, 24
52, 17644, 93995, 111639, 109, 25
53, 17324, 100410, 117734, 98, 28
54, 67369, 102657, 170026, 114, 30
55, 19569, 153664, 173233, 103, 31
56, 19890, 99448, 119338, 130, 29
57, 19890, 102336, 122226, 117, 27
58, 21815, 142757, 164572, 130, 32
59, 21173, 108751, 129924, 122, 32
60, 23418, 162005, 185423, 130, 31
61, 22777, 106827, 129604, 117, 27
62, 25023, 119338, 144361, 146, 27
63, 25023, 115489, 140512, 123, 34
64, 25664, 129283, 154947, 142, 21
65, 27268, 115168, 142436, 137, 34
66, 25343, 117092, 142435, 133, 33
67, 26627, 118376, 145003, 143, 38
68, 28551, 119338, 147889, 142, 32
69, 31118, 128962, 160080, 147, 32
70, 30476, 119659, 150135, 157, 34
71, 33042, 119659, 152701, 154, 31
72, 31760, 127359, 159119, 156, 34
73, 33685, 443348, 477033, 145, 29
74, 31118, 144040, 175158, 133, 33
75, 70256, 128642, 198898, 163, 36
76, 36892, 127679, 164571, 151, 37
77, 35288, 127038, 162326, 139, 39
78, 36571, 136341, 172912, 149, 43
79, 41063, 132491, 173554, 164, 31
80, 40742, 131850, 172592, 151, 33
81, 42345, 134737, 177082, 158, 43
82, 40101, 139549, 179650, 148, 37
83, 42667, 139548, 182215, 187, 43
84, 41383, 147568, 188951, 171, 43
85, 42988, 136661, 179649, 176, 40
86, 45554, 140832, 186386, 175, 42
87, 45875, 143398, 189273, 148, 40
88, 46837, 145324, 192161, 181, 47
89, 50366, 147569, 197935, 200, 47
90, 48120, 158155, 206275, 191, 51
91, 50045, 165213, 215258, 173, 48
92, 51329, 145965, 197294, 198, 43
93, 52612, 175479, 228091, 177, 45
94, 52611, 151098, 203709, 169, 46
95, 54857, 155268, 210125, 198, 53
96, 54857, 155909, 210766, 171, 47
97, 56141, 164892, 221033, 198, 46
98, 58707, 163609, 222316, 187, 50
99, 59669, 161364, 221033, 210, 50
100, 61915, 160080, 221995, 218, 53
101, 64802, 165213, 230015, 212, 56
102, 64161, 164571, 228732, 211, 53
103, 73142, 161684, 234826, 216, 52
104, 64482, 159438, 223920, 231, 41
105, 66727, 165854, 232581, 229, 48
106, 67369, 170988, 238357, 204, 63
107, 68010, 175157, 243167, 220, 44
108, 73143, 174195, 247338, 235, 54
109, 71859, 173554, 245413, 219, 56
110, 72822, 174837, 247659, 225, 59
111, 73464, 172591, 246055, 219, 54
112, 75388, 177724, 253112, 233, 65
113, 74747, 173554, 248301, 226, 55
114, 68651, 158476, 227127, 234, 60
115, 69293, 164251, 233544, 228, 66
116, 80201, 180932, 261133, 244, 58
117, 80201, 179007, 259208, 244, 61
118, 75709, 169063, 244772, 251, 58
119, 76992, 175158, 252150, 242, 62
120, 84692, 175479, 260171, 261, 58
121, 84050, 178687, 262737, 283, 60
122, 82446, 176441, 258887, 250, 62
123, 84692, 181895, 266587, 262, 69
124, 86295, 177403, 263698, 262, 62
125, 86937, 176761, 263698, 253, 59
126, 94316, 220391, 314707, 239, 54
127, 176120, 243488, 419608, 246, 59
128, 94637, 188952, 283589, 270, 63
129, 93674, 185745, 279419, 249, 65
130, 93674, 182537, 276211, 245, 60
131, 97524, 189594, 287118, 294, 59
132, 100090, 194406, 294496, 288, 68
133, 98807, 191840, 290647, 266, 64
134, 104261, 192802, 297063, 277, 61
135, 110676, 208200, 318876, 265, 71
136, 102336, 243489, 345825, 255, 81
137, 102015, 276210, 378225, 276, 62
138, 94957, 184461, 279418, 269, 57
139, 101373, 220391, 321764, 288, 67
140, 188953, 383358, 572311, 259, 72
141, 105223, 189594, 294817, 298, 64
142, 104903, 195689, 300592, 256, 66
143, 244451, 222958, 467409, 306, 76
144, 114847, 200501, 315348, 244, 76
145, 117092, 332029, 449121, 306, 71
146, 112601, 204992, 317593, 267, 76
147, 120301, 250867, 371168, 312, 72
148, 120301, 207879, 328180, 301, 73
149, 123187, 212691, 335878, 284, 85
150, 125434, 312461, 437895, 316, 83
151, 128962, 213333, 342295, 326, 89
152, 128000, 212691, 340691, 336, 77
153, 123829, 210766, 334595, 289, 82
154, 120301, 206275, 326576, 334, 73
155, 119980, 233544, 353524, 328, 75
156, 123188, 209162, 332350, 317, 75
157, 122546, 328180, 450726, 301, 86
158, 139869, 216862, 356731, 303, 70
159, 133133, 229052, 362185, 350, 84
160, 128641, 216862, 345503, 316, 80
161, 142757, 215258, 358015, 307, 77
162, 135379, 215578, 350957, 342, 78
163, 141153, 218466, 359619, 324, 81
164, 149494, 227128, 376622, 360, 82
165, 149815, 227128, 376943, 307, 80
166, 154626, 276852, 431478, 339, 81
167, 227448, 237394, 464842, 338, 86
168, 174516, 235147, 409663, 341, 88
169, 176762, 232902, 409664, 334, 91
170, 162967, 276211, 439178, 356, 87
171, 153664, 229053, 382717, 348, 84
172, 245734, 334596, 580330, 343, 89
173, 165212, 305724, 470936, 332, 87
174, 162325, 293534, 455859, 332, 85
175, 169383, 241563, 410946, 348, 87
176, 169704, 234827, 404531, 348, 89
177, 158156, 235148, 393304, 367, 90
178, 160081, 237393, 397474, 353, 91
179, 166496, 238035, 404531, 332, 89
180, 204672, 274607, 479279, 349, 97
181, 180291, 256962, 437253, 373, 97
182, 179649, 252471, 432120, 368, 101
183, 167779, 269794, 437573, 362, 87
184, 186065, 252150, 438215, 378, 100
185, 218787, 255359, 474146, 370, 96
186, 183177, 258246, 441423, 402, 97
187, 178686, 252792, 431478, 355, 90
188, 178686, 246055, 424741, 400, 93
189, 195369, 262095, 457464, 389, 96
190, 196330, 261133, 457463, 408, 95
191, 182857, 300271, 483128, 387, 96
192, 185102, 277172, 462274, 416, 89
193, 184140, 252791, 436931, 368, 101
194, 238997, 277494, 516491, 385, 101
195, 197293, 265303, 462596, 421, 94
196, 217183, 256000, 473183, 405, 91
197, 222316, 260171, 482487, 378, 98
198, 217504, 271078, 488582, 404, 101
199, 207559, 264341, 471900, 400, 94
200, 204992, 286797, 491789, 409, 105
